#,#,#,#,#,#,#,#,#,#,#,#,#,#,#,#,#,#,#,#,#
#,_,_,_,_,M,_,M,_,_,_,_,#,_,_,M,_,_,_,_,#
#,#,#,_,#,#,#,#,#,#,#,#,#,_,#,_,#,#,#,#,#
#,_,_,_,_,_,_,_,_,_,_,T,#,_,#,M,_,_,_,_,#
#,#,#,#,#,_,#,#,#,#,#,#,#,_,#,#,#,#,#,#,#
#,_,_,_,_,M,L,L,_,_,_,M,_,_,_,M,#,_,#,E,#
#,#,#,#,#,_,#,#,#,#,#,#,#,_,#,_,#,_,#,B,#
#,_,#,_,#,M,_,_,_,_,#,_,#,_,#,_,#,_,#,_,#
#,_,#,_,#,_,#,#,#,#,#,_,#,_,#,_,#,_,#,_,#
#,T,#,M,#,M,_,_,_,_,#,_,#,_,#,_,#,_,_,_,#
#,_,#,_,#,#,#,_,#,#,#,_,#,_,#,_,#,_,#,#,#
#,_,#,T,_,_,_,_,_,_,#,_,#,_,#,T,#,_,#,M,#
#,_,#,_,#,_,#,#,#,_,#,_,#,#,#,_,#,_,#,_,#
S,_,#,M,#,_,#,_,_,_,_,_,#,_,#,_,#,T,_,M,#
#,_,#,_,#,#,#,#,#,#,#,_,#,_,#,_,#,_,#,_,#
#,_,#,_,#,_,#,_,_,_,_,_,#,_,_,_,#,_,#,_,#
#,_,#,_,#,_,#,_,#,#,#,_,#,_,#,_,#,_,#,_,#
#,_,_,_,#,T,_,L,_,_,#,_,#,M,#,_,#,_,#,M,#
#,_,#,_,#,#,#,#,#,#,#,_,#,_,#,#,#,#,#,_,#
#,T,#,_,#,T,_,_,_,_,_,_,#,_,_,M,_,_,_,_,#
#,#,#,#,#,#,#,#,#,#,#,#,#,#,#,#,#,#,#,#,#
