#,#,#,#,#,#,#,#,#,#,#,#,#,#,#,#,#,#,#,#,#,#,#,#,#,#,#
#,_,#,L,_,_,_,_,#,_,#,_,_,_,_,_,_,T,_,L,_,_,_,T,_,_,#
#,_,#,#,#,_,#,_,#,_,#,#,#,#,#,#,#,#,#,_,#,#,#,_,#,#,#
#,_,_,_,_,L,#,_,#,_,#,_,_,_,_,_,_,_,_,T,_,_,#,_,#,_,#
#,_,#,_,#,#,#,#,#,_,#,_,#,_,#,#,#,#,#,#,#,_,#,_,#,_,#
#,_,#,M,_,_,_,_,_,_,#,_,#,_,_,_,_,_,#,_,_,_,#,_,_,_,S
#,_,#,#,#,#,#,_,#,#,#,#,#,#,#,#,#,_,#,#,#,#,#,#,#,_,#
#,_,#,_,_,L,_,_,_,_,#,_,#,M,#,_,_,L,_,_,_,_,#,M,#,_,#
#,_,#,#,#,#,#,_,#,_,#,_,#,_,#,_,#,#,#,#,#,#,#,_,#,_,#
#,_,#,_,_,_,_,_,#,T,#,M,#,M,#,L,_,_,_,_,_,_,#,_,_,_,#
#,#,#,_,#,#,#,#,#,#,#,_,#,_,#,_,#,_,#,_,#,_,#,_,#,_,#
#,T,_,_,_,M,_,_,#,T,#,_,_,T,_,M,#,_,#,_,#,_,#,M,#,M,#
#,_,#,#,#,_,#,#,#,_,#,#,#,_,#,#,#,_,#,#,#,#,#,_,#,_,#
#,_,#,_,_,_,_,_,#,_,#,_,_,_,#,_,_,M,_,L,_,_,#,_,#,_,#
#,_,#,#,#,#,#,_,#,_,#,_,#,#,#,_,#,#,#,#,#,#,#,_,#,_,#
#,_,#,_,_,_,_,_,_,_,_,_,_,_,#,_,_,M,_,_,_,_,#,_,#,_,#
#,#,#,#,#,#,#,#,#,_,#,#,#,#,#,#,#,#,#,#,#,#,#,#,#,#,#
#,_,_,_,_,_,_,M,_,_,#,T,_,_,_,M,_,_,_,_,_,_,_,M,_,_,#
#,#,#,#,#,#,#,#,#,_,#,_,#,#,#,#,#,#,#,#,#,#,#,#,#,#,#
#,_,#,_,#,_,_,_,_,_,#,_,#,_,#,_,_,_,_,_,#,M,_,_,_,_,#
#,_,#,_,#,_,#,#,#,_,#,_,#,_,#,#,#,_,#,_,#,_,#,_,#,#,#
#,_,#,_,#,_,_,_,#,_,#,_,_,_,#,_,_,_,#,_,_,_,#,_,_,_,#
#,_,#,_,#,_,#,_,#,_,#,_,#,#,#,#,#,_,#,_,#,_,#,_,#,#,#
#,_,_,M,_,_,#,_,#,_,#,_,_,_,#,_,_,_,#,_,#,_,#,_,B,E,#
#,#,#,_,#,_,#,#,#,_,#,_,#,_,#,#,#,_,#,_,#,#,#,#,#,#,#
#,_,_,_,#,_,_,_,#,_,_,_,#,_,_,_,_,_,#,M,_,_,_,_,_,_,#
#,#,#,#,#,#,#,#,#,#,#,#,#,#,#,#,#,#,#,#,#,#,#,#,#,#,#
