#,#,#,#,#,#,#,#,#,#,#,#,#,#,#,#,#,#,#,#,#,#,#,#,#,#,#
#,_,_,_,_,_,_,_,_,_,_,_,_,M,_,_,_,_,_,M,#,_,_,L,_,_,#
#,#,#,#,#,#,#,#,#,_,#,#,#,#,#,#,#,#,#,#,#,_,#,#,#,#,#
#,_,_,_,#,_,_,T,_,_,_,M,_,_,#,_,_,_,#,_,#,_,#,L,#,_,#
#,#,#,_,#,#,#,#,#,_,#,#,#,_,#,_,#,#,#,_,#,_,#,_,#,_,#
#,L,#,_,#,_,_,_,_,_,#,_,_,_,#,_,_,_,_,_,#,_,#,_,#,T,#
#,_,#,_,#,_,#,#,#,#,#,#,#,#,#,#,#,_,#,#,#,_,#,_,#,_,#
#,_,_,M,#,_,_,_,_,_,_,_,_,_,#,_,#,_,_,_,#,M,#,_,#,_,#
#,_,#,_,#,#,#,#,#,#,#,_,#,#,#,_,#,_,#,#,#,_,#,_,#,_,#
#,_,#,_,_,_,_,L,_,M,_,_,_,_,_,M,_,L,_,_,#,_,#,_,#,_,#
#,_,#,#,#,#,#,#,#,_,#,#,#,#,#,#,#,#,#,#,#,_,#,_,#,_,#
#,_,#,E,#,_,_,_,#,_,_,_,_,M,_,L,_,_,_,T,#,_,_,_,#,_,#
#,_,#,B,#,_,#,#,#,#,#,#,#,#,#,#,#,_,#,#,#,_,#,_,#,_,#
#,_,#,_,#,_,#,_,#,_,#,_,#,_,#,_,_,_,#,_,#,M,#,_,#,_,#
#,_,#,_,#,_,#,_,#,_,#,_,#,_,#,_,#,_,#,_,#,_,#,_,#,_,#
#,_,#,_,#,_,#,_,#,_,_,_,#,_,_,_,#,_,#,_,#,M,#,T,_,_,#
#,_,#,_,#,_,#,_,#,_,#,_,#,#,#,#,#,_,#,_,#,_,#,_,#,_,#
#,M,#,_,#,_,_,_,#,_,#,M,#,_,_,_,_,_,#,_,#,_,#,_,#,_,#
#,_,#,_,#,_,#,_,#,#,#,_,#,#,#,#,#,_,#,_,#,_,#,_,#,_,#
#,_,#,_,#,_,#,_,#,_,#,_,#,_,_,_,_,_,_,_,#,_,#,_,#,_,#
#,_,#,_,#,_,#,_,#,_,#,_,#,#,#,_,#,_,#,_,#,_,#,_,#,#,#
#,_,#,M,#,_,#,L,#,_,_,_,_,_,_,_,#,_,#,_,#,_,#,_,_,_,#
#,_,#,_,#,_,#,_,#,#,#,#,#,_,#,#,#,#,#,#,#,_,#,_,#,#,#
#,_,#,_,#,_,#,_,_,_,_,_,_,_,_,_,_,M,#,_,#,_,#,L,#,M,#
#,_,#,_,#,_,#,_,#,#,#,_,#,#,#,#,#,#,#,_,#,_,#,_,#,_,#
#,M,_,L,#,_,#,_,#,_,_,_,_,_,_,T,_,_,_,T,_,_,#,_,_,_,#
#,#,#,#,#,#,#,#,#,#,#,#,#,#,#,#,#,#,#,#,#,S,#,#,#,#,#
