#,#,#,S,#,#,#,#,#,#,#,#,#,#,#,#,#,#,#,#,#
#,_,_,M,#,T,_,L,_,_,#,_,#,T,#,_,#,_,#,T,#
#,_,#,#,#,_,#,_,#,_,#,_,#,_,#,_,#,_,#,_,#
#,_,#,_,#,_,#,_,#,_,_,L,#,_,#,_,#,L,#,_,#
#,_,#,_,#,_,#,_,#,_,#,_,#,_,#,_,#,_,#,_,#
#,_,#,_,_,_,#,_,#,_,#,_,#,_,_,M,#,_,#,M,#
#,_,#,_,#,_,#,#,#,_,#,_,#,_,#,_,#,_,#,_,#
#,M,#,_,#,_,#,_,#,_,#,_,_,M,#,_,#,_,#,_,#
#,_,#,_,#,_,#,_,#,_,#,_,#,#,#,_,#,_,#,_,#
#,_,_,_,#,_,_,_,#,L,#,_,#,_,_,_,#,_,#,_,#
#,#,#,_,#,_,#,#,#,#,#,_,#,#,#,_,#,_,#,_,#
#,_,#,_,#,_,_,_,_,_,#,_,#,_,#,_,#,_,_,_,#
#,_,#,_,#,_,#,#,#,_,#,_,#,_,#,_,#,_,#,_,#
#,_,_,_,#,T,#,M,_,L,#,M,#,_,_,_,_,_,#,_,#
#,#,#,#,#,#,#,#,#,#,#,_,#,#,#,#,#,_,#,_,#
#,M,_,_,_,_,_,T,#,_,#,_,_,L,_,M,#,_,#,_,#
#,#,#,#,#,#,#,_,#,_,#,_,#,#,#,_,#,_,#,_,#
#,_,_,_,_,_,_,_,_,_,_,_,_,_,#,_,#,_,#,_,#
#,#,#,#,#,#,#,#,#,#,#,#,#,#,#,#,#,#,#,_,#
#,E,B,_,_,M,_,_,_,_,_,_,_,_,_,_,_,_,_,T,#
#,#,#,#,#,#,#,#,#,#,#,#,#,#,#,#,#,#,#,#,#
