{
  "maze": [
    ["#","S","#","#","#","#","#","#","#","#","#","#","#","#","#","#","#"],
    ["#"," "," "," "," "," "," ","L"," ","G"," "," ","#"," "," "," ","#"],
    ["#","#","#","#","#"," ","#","#","#","#","#","#","#","#","#"," ","#"],
    ["#","G","#"," "," "," "," "," ","#"," "," "," ","#"," "," "," ","#"],
    ["#"," ","#"," ","#"," ","#","#","#"," ","#","#","#"," ","#"," ","#"],
    ["#"," "," "," ","#"," "," ","G"," "," "," "," ","#"," ","#"," ","#"],
    ["#","#","#"," ","#"," ","#","#","#","#","#","#","#","B","#"," ","#"],
    ["#"," "," "," ","#","T","#"," "," "," "," "," ","#","E","#","G","#"],
    ["#"," ","#","#","#"," ","#"," ","#"," ","#"," ","#","#","#"," ","#"],
    ["#"," "," "," ","#"," "," "," ","#","T","#","G","#","G","#"," ","#"],
    ["#"," ","#"," ","#"," ","#"," ","#","#","#"," ","#"," ","#"," ","#"],
    ["#"," ","#","T","#","T","#","G","#","T"," "," ","#"," ","#","L","#"],
    ["#"," ","#"," ","#"," ","#","#","#","#","#","#","#"," ","#"," ","#"],
    ["#"," ","#"," ","#"," "," ","T","#"," "," "," ","#","G"," "," ","#"],
    ["#"," ","#"," ","#"," ","#"," ","#"," ","#","#","#"," ","#"," ","#"],
    ["#","T","#"," ","#"," ","#"," "," ","G","L","G"," ","G","#","G","#"],
    ["#","#","#","#","#","#","#","#","#","#","#","#","#","#","#","#","#"]
  ]
}
