{
  "maze": [
    ["#","#","#","#","#","#","#","#","#","#","#","#","#","#","#","#","#"],
    ["#","G"," "," "," ","G"," "," "," "," ","#"," "," ","T"," "," ","#"],
    ["#","#","#"," ","#","#","#","#","#"," ","#","#","#"," ","#","#","#"],
    ["#"," "," "," "," ","T","#"," "," "," ","#","G"," "," "," ","T","#"],
    ["#","#","#","#","#","#","#","#","#"," ","#","#","#"," ","#","#","#"],
    ["#"," ","#"," ","#"," "," ","G"," "," ","#","T"," "," ","#"," ","#"],
    ["#"," ","#"," ","#","#","#","#","#"," ","#","#","#"," ","#"," ","#"],
    ["#"," "," "," "," "," "," "," "," "," ","#"," "," "," "," "," ","#"],
    ["#","#","#","#","#","#","#"," ","#","#","#"," ","#"," ","#"," ","#"],
    ["#"," "," "," "," "," ","#"," "," "," "," ","G","#","L","#","G","#"],
    ["#"," ","#"," ","#","#","#","#","#"," ","#","#","#","#","#"," ","#"],
    ["#","G","#"," ","L"," "," "," ","#","G","#","T","#"," ","#"," ","#"],
    ["#"," ","#","#","#"," ","#"," ","#"," ","#"," ","#"," ","#"," ","#"],
    ["#"," ","#"," "," ","G","#","G","#"," ","#"," "," "," "," "," ","#"],
    ["#","B","#"," ","#"," ","#"," ","#"," ","#","#","#"," ","#"," ","#"],
    ["#","E","#"," ","#","G","#"," "," "," ","#"," "," "," ","#"," ","S"],
    ["#","#","#","#","#","#","#","#","#","#","#","#","#","#","#","#","#"]
  ]
}
