{
  "maze": [
    ["#","#","#","#","#","#","#","#","#","#","#","#","#","#","#","#","#"],
    ["#"," "," "," "," "," "," "," ","#"," "," "," "," "," "," "," ","#"],
    ["#","#","#","#","#"," ","#"," ","#"," ","#","#","#","#","#","#","#"],
    ["#","L"," ","T"," "," ","#"," "," ","G","#"," "," "," "," "," ","#"],
    ["#"," ","#"," ","#","#","#"," ","#"," ","#"," ","#"," ","#"," ","#"],
    ["#"," ","#"," "," "," ","#","G","#"," "," "," ","#","G","#","G","#"],
    ["#"," ","#","#","#","#","#","#","#"," ","#","#","#","#","#","#","#"],
    ["S","G"," ","T"," "," "," "," ","#","T"," ","G"," "," ","#"," ","#"],
    ["#"," ","#","#","#","#","#","#","#","#","#","#","#"," ","#"," ","#"],
    ["#","G","#"," "," "," ","#","G","#"," ","#","G"," "," "," "," ","#"],
    ["#"," ","#"," ","#","#","#"," ","#"," ","#"," ","#"," ","#"," ","#"],
    ["#"," "," ","G"," "," "," "," ","#"," ","#"," ","#"," ","#"," ","#"],
    ["#"," ","#"," ","#"," ","#"," ","#"," ","#"," ","#","#","#"," ","#"],
    ["#"," ","#"," ","#","G","#","G","#","G"," "," "," ","T","#"," ","#"],
    ["#"," ","#"," ","#","#","#"," ","#","#","#","#","#","#","#"," ","#"],
    ["#","G","#"," "," "," ","#"," ","#","E","B","G"," "," "," "," ","#"],
    ["#","#","#","#","#","#","#","#","#","#","#","#","#","#","#","#","#"]
  ]
}
