{
  "maze": [
    ["#","#","#","#","#","#","#","#","#","#","#","#","#","#","#","#","#"],
    ["#"," ","#","E","B"," "," "," "," "," "," "," "," ","T","#"," ","#"],
    ["#"," ","#","#","#","#","#","#","#"," ","#","#","#","#","#"," ","#"],
    ["#"," ","#","G"," ","L"," "," "," "," "," ","G"," "," ","#","T","#"],
    ["#"," ","#","#","#"," ","#","#","#","#","#","#","#","#","#"," ","#"],
    ["#"," ","#"," "," "," "," "," "," ","G"," "," "," "," ","#"," ","#"],
    ["#"," ","#","#","#","#","#","#","#"," ","#","#","#","#","#"," ","#"],
    ["S"," ","#"," ","#","G"," "," "," ","G","#"," "," "," ","#","G","#"],
    ["#"," ","#"," ","#"," ","#","#","#","#","#","#","#"," ","#"," ","#"],
    ["#"," ","#"," ","#","L"," ","T","#"," "," ","G","#","G","#"," ","#"],
    ["#"," ","#"," ","#","#","#"," ","#"," ","#"," ","#"," ","#"," ","#"],
    ["#"," ","#","G","#"," "," "," "," "," ","#"," "," ","G","#"," ","#"],
    ["#"," ","#"," ","#"," ","#"," ","#"," ","#"," ","#"," ","#"," ","#"],
    ["#"," "," "," "," "," ","#"," ","#"," ","#","G","#","G"," "," ","#"],
    ["#","#","#","#","#"," ","#","#","#","#","#","#","#","#","#","#","#"],
    ["#"," "," "," "," "," "," "," "," "," "," "," "," ","G"," "," ","#"],
    ["#","#","#","#","#","#","#","#","#","#","#","#","#","#","#","#","#"]
  ]
}
